Điểm lại 22 nhà vô địch Đường lên đỉnh Olympia qua các năm
Đường lên đỉnh Olympia đã tìm được 22 gương mặt xuất sắc nhất trở thành quán quân từ lần đầu phát sóng và nhà vô địch năm thứ 23 cũng sắp lộ diện.
Danh sách các nhà vô địch Đường lên đỉnh Olympia như sau:
1. Trần Ngọc Minh - THPT Chuyên Nguyễn Bỉnh Khiêm, Vĩnh Long.
2. Phan Mạnh Tân - THPT Năng khiếu Hà Tĩnh, Hà Tĩnh.
3. Lương Phương Thảo - THPT Chuyên Nguyễn Bỉnh Khiêm, Vĩnh Long.
4. Võ Văn Dũng - THPT Chuyên Lê Quý Đôn, Đà Nẵng.
5. Đỗ Lâm Hoàng - THPT Gò Vấp, TP Hồ Chí Minh.
6. Lê Vũ Hoàng - THPT số 1 Bố Trạch, Quảng Bình.
7. Lê Viết Hà - THPT Chuyên Lê Khiết, Quảng Ngãi.
8. Huỳnh Anh Vũ - THPT Tăng Bạt Hổ, Bình Định.
9. Hồ Ngọc Hân - THPT Chuyên Quốc Học - Huế, Thừa Thiên Huế.
10. Phan Minh Đức - THPT Chuyên Hà Nội - Amsterdam, Hà Nội.
11. Phạm Thị Ngọc Oanh - THPT Tiên Lãng, Hải Phòng.
12. Đặng Thái Hoàng - THPT Hòn Gai, Quảng Ninh.
13. Hoàng Thế Anh - THPT Chuyên Bắc Giang, Bắc Giang.
14. Nguyễn Trọng Nhân - THPT Chuyên Tiền Giang, Tiền Giang.
15. Văn Viết Đức - THPT Thị xã Quảng Trị, Quảng Trị.
16. Hồ Đắc Thanh Chương - THPT Chuyên Quốc Học - Huế, Thừa Thiên Huế.
17. Phan Đăng Nhật Minh - THPT Hải Lăng, Quảng Trị.
18. Nguyễn Hoàng Cường - THPT Hòn Gai, Quảng Ninh.
19. Trần Thế Trung - THPT Chuyên Phan Bội Châu, Nghệ An.
20. Nguyễn Thị Thu Hằng - THPT Kim Sơn A, Ninh Bình.
21. Nguyễn Hoàng Khánh - THPT Bạch Đằng, Quảng Ninh.
22. Đặng Lê Nguyên Vũ - THPT Bắc Duyên Hà, Thái Bình.
Như vậy, đến nay, đã có 17/63 tỉnh, thành có quán quân Đường lên đỉnh Olympia, gồm:  Vĩnh Long, Hà Tĩnh, Đà Nẵng, TP.HCM, Quảng Bình, Quãng Ngãi, Bình Định, Thừa Thiên Huế, Hà Nội, Hải Phòng, Quảng Ninh, Bắc Giang, Tiền Giang, Quảng Trị, Nghệ An, Ninh Bình, Thái Bình.
Trong đó, Quảng Ninh là tỉnh hiện có nhiều nhà vô địch Olympia nhất với 3 thí sinh. 3 tỉnh có 2 quán quân Olympia là Vĩnh Long, Thừa Thiên Huế, Quảng Trị. Trong số 22 quán quân, có 4 quán quân là nữ.
Năm 2023, 4 thí sinh góp mặt tại trận chung kết năm Đường lên đỉnh Olympia diễn ra ngày 8/10 tới đây đến từ: Hà Nội, Hải Phòng, Thừa Thiên Huế, Thanh Hóa.
Như vậy, Thừa Thiên Huế đứng trước cơ hội san bằng cách biệt với Quảng Ninh để trở thành các tỉnh cùng có số quán quân nhiều nhất (3 quán quân - nếu thí sinh Nguyễn Minh Triết giành chiến thắng).
Hà Nội hoặc Hải Phòng cũng có cơ hội vươn lên là địa phương có 2 quán quân Olympia (nếu Nguyễn Việt Thành hoặc Nguyễn Trọng Thành chiến thắng). Thanh Hóa cũng đứng trước cơ hội được ghi tên mình vào danh sách những tỉnh, thành có quán quân (nếu thí sinh Lê Xuân Mạnh chiến thắng).
Trận chung kết năm Đường lên đỉnh Olympia năm thứ 23 được truyền hình trực tiếp vào 8h30 ngày Chủ nhật 8/10/2023 trên VTV3.
4 thí sinh góp mặt tại trận đấu quan trọng rất được chờ đợi này gồm: Nguyễn Việt Thành (học sinh Trường THPT Sóc Sơn, Hà Nội); Nguyễn Minh Triết (học sinh Trường THPT Chuyên Quốc học, Thừa Thiên - Huế); Lê Xuân Mạnh (học sinh Trường THPT Hàm Rồng - Thanh Hóa); Nguyễn Trọng Thành (học sinh Trường THPT Chuyên Trần Phú, Hải Phòng).  
Thí giành chiến thắng trận chung kết năm sẽ nhận được vòng nguyệt quế, cúp kỷ niệm cùng phần thưởng trị giá 40.000 USD và cơ hội du học. Các thí sinh về Nhì và Ba nhận giải thưởng trị giá 100 và 50 triệu đồng.
